1|4|0|683|383
1|3|0|584|335
1|5|0|784|334
1|5|0|834|285
1|3|0|534|286
1|3|0|434|185
1|5|0|935|188
1|3|1|634|235
1|5|1|734|235
1|4|1|685|185
