2|4|1|308|108
3|4|2|409|59
4|4|0|235|82
4|4|0|384|185
4|4|0|536|285
4|4|0|834|286
4|4|0|984|184
4|4|0|1136|84
2|4|1|458|210
2|4|1|607|310
2|4|1|757|311
2|4|1|910|210
2|4|1|1059|111
3|4|2|491|133
3|4|2|581|187
3|4|2|784|187
3|4|2|885|131
3|4|2|958|62
2|0|3|682|285
2|0|3.2|682|236
2|0|3.4|682|186
2|0|3.6|682|136
4|0|4|685|336
