1|4|0|634|334
1|3|0|535|285
1|4|0|483|233
1|3|0|533|184
1|4|0|634|132
1|4|0|734|133
1|4|0|734|336
1|5|0|834|288
1|5|0|834|183
1|4|0|887|235
1|2|0|233|185
1|2|0|332|235
1|2|0|384|334
1|6|0|984|337
1|6|0|1035|233
1|6|0|1136|183
1|2|0|386|136
1|2|0|484|85
1|6|0|1034|132
1|6|0|936|83
