1|4|0|409|209
2|4|1|459|159
3|4|2|607|109
1|4|0|484|280
1|4|0|584|331
1|4|0|685|383
1|4|0|785|332
1|4|0|886|285
1|4|0|959|212
2|4|1|534|234
2|4|1|635|283
2|4|1|734|284
2|4|1|837|236
2|4|1|911|161
3|4|2|761|110
1|4|3|535|109
1|4|3|684|109
1|4|3|609|159
1|4|3|607|60
1|4|3|761|59
1|4|3|760|159
1|4|3|836|110
