1|4|0|635|336
1|4|0|484|283
1|4|0|333|229
1|4|0|734|336
1|4|0|884|284
1|4|0|1037|231
1|2|1|433|180
1|2|1|534|233
1|2|1|632|281
1|6|1|736|283
1|6|1|833|235
1|6|1|937|185
