1|4|0|258|161
2|4|0|357|160
3|4|0|459|160
4|4|0|559|158
1|4|0|1108|161
2|4|0|1010|155
3|4|0|907|159
4|4|0|809|159
