1|4|0|538|282
2|4|0|682|364
3|3|0|381|183
1|4|0|835|282
1|4|0|633|335
1|4|0|755|311
3|5|0|984|185
3|3|0|433|234
3|5|0|933|233
3|3|2|583|185
3|5|2|783|183
