1|2|2|359|310
2|1|0|259|62
2|1|0|384|132
2|1|0|533|186
2|7|0|833|188
2|7|0|986|132
2|7|0|1109|60
2|4|3|684|134
2|4|3|632|185
2|4|3|735|187
2|4|3|683|237
2|4|3|384|36
2|4|3|884|85
2|4|3|487|83
2|4|3|987|34
2|2|1|409|257
2|2|1|308|310
2|2|1|509|257
2|2|1|609|309
2|6|1|758|310
2|6|1|858|259
2|6|1|959|259
2|6|1|1060|311
1|2|2|458|257
1|2|2|559|309
1|6|2|809|310
1|6|2|908|259
1|6|2|1008|308
