3|2|0|610|111
4|2|1|531|212
5|2|2|485|161
3|2|0|609|210
3|2|0|658|159
3|6|0|759|110
3|6|0|708|159
3|6|0|758|209
4|2|1|585|159
4|2|1|534|111
4|6|1|833|110
4|6|1|784|161
4|6|1|831|209
5|2|2.2|382|160
5|2|2.4|283|159
5|6|2.4|884|160
5|6|2.2|985|161
5|6|2.4|1085|162
