1|4|0|538|333
2|4|2|684|85
1|4|0|432|282
1|4|0|335|333
1|4|0|635|284
1|4|0|234|282
1|4|0|738|283
1|4|0|834|333
1|4|0|936|284
1|4|0|1036|337
1|4|0|1135|284
1|4|3|284|334
1|4|3|383|285
1|4|3|487|333
1|4|3|586|284
1|4|3|785|283
1|4|3|885|333
1|4|3|985|283
1|4|3|1086|337
1|2|2|286|235
1|2|2|384|182
1|2|2|534|133
1|6|2|833|134
1|6|2|1085|234
1|6|2|985|184
